11111
1P001
101E1
10C11
11110
