111111111
100010001
10P010E01
100010001
10C000001
100000001
10A000C01
100000001
111111111
