1111111
1P000A1
1000001
100C001
1000001
1C000E1
1111111
