111111111111111
100010000000001
10P010000000C01
100010000000001
100000C01111101
100010001000001
10C010001000001
10001000000C001
100011111000001
100000001000001
100000C01111101
100000000000001
10E000000C00A01
100000000000001
111111111111111
