111111111111111
100010000000001
10P0000C0000A01
100010000000001
100011011110101
100010000010001
100010000000001
10C0100C0010C01
100000000010001
100010000010001
101011110110001
100000000010001
10A0000C0000E01
100000000010001
111111111111111
