1111111111111111111111111111111
1000001000001000001000001000001
1000001000001000001000001000001
100C00100C00000000000000000C001
1000001000001000001000001000001
1000001000001000001000001000001
1110111111111110111110111111111
1000001000001000001000001000001
1000001000001000001000001000001
100000000A00000C00100C00100C001
1000001000001000001000001000001
1000001000001000001000001000001
1110111111111111111110111110111
1000001000001000001000001000001
1000001000001000001000001000001
100000000000000P000000000000001
1000001000001000001000001000001
1000001000001000001000001000001
1110111110111110111111111110111
1000001000001000001000001000001
1000001000001000001000001000001
100C00100000000C00000000100C001
1000001000001000001000001000001
1000001000001000001000001000001
1110111110111111111110111110111
1000001000001000001000001000001
1000001000001000001000001000001
100000000C00100E00000A000000001
1000001000001000001000001000001
1000001000001000001000001000001
1111111111111111111111111111111
