111111111111111111111111111111111111111
100000000000000000000000000000000000001
10P000000000000000000000000000000000C01
100000000000000000000000000000000000001
100000000000000000000000000000000000001
100000000000000000000000000000000000001
100000000000000000000000000000000000001
100000000000000000000000000000000000001
100000000000000000000000000000000000001
100000000000000000000000000000000000001
100000000000000000000000000000000000001
100000000000000000000000000000000000001
100000000000000000000000000000000000001
100000000000000000000000000000000000001
1000000000000000000A0000000000000000001
1000000000000000A00000A0000000000000001
1000000000000000000A0000000000000000001
100000000000000000A0A000000000000000001
100000000000000A0A0A0A0A000000000000001
100000000000000000A0A000000000000000001
1000000000000000000A0000000000000000001
1000000000000000A00000A0000000000000001
1000000000000000000A0000000000000000001
100000000000000000000000000000000000001
100000000000000000000000000000000000001
100000000000000000000000000000000000001
100000000000000000000000000000000000001
100000000000000000000000000000000000001
100000000000000000000000000000000000001
100000000000000000000000000000000000001
100000000000000000000000000000000000001
100000000000000000000000000000000000001
100000000000000000000000000000000000001
100000000000000000000000000000000000001
100000000000000000000000000000000000001
100000000000000000000000000000000000001
10C000000000000000000000000000000000E01
100000000000000000000000000000000000001
111111111111111111111111111111111111111