1111111111111111111111111111111
1000001000001000001000001000001
1000000000001000001000000000001
100A00000C00000000000C00000A001
1000000000001000001000000000001
1000001000001000001000001000001
1110111111111110111110111111111
1000001000001000001000001000001
1000001000000000001000000000001
100000000000C0000010000C0000001
1000001000000000001000000000001
1000001000001000001000001000001
110C011110111111111111111100011
100000100000100000100000100C001
1000001000000000000000001000001
10000000000C000P000C00000000001
1000001000000000000000001000001
1000001000001000001000001000001
1110111110111111111110111110111
1000001000001000001000001000001
1000001000000000000000001000001
100C0010000C0000000C0000100C001
1000001000000000000000001000001
1000001000001000001000001000001
1100011110111111111110111100011
1000001000001000001000001000001
1000001000001000000000001000001
100A00000000000E00000C00000A001
1000001000001000000000001000001
1000001000001000001000001000001
1111111111111111111111111111111
