1111111111111111111
1000000001000000001
1011011101011101101
10C101000C000101C01
1011010111110101101
100000000C000000001
1011010111110101101
1000010001000100001
1111011101011101111
1001010000000101001
1001010110110101001
1C000001AAA100000E1
1001010111110101001
100101000P000101001
1111010111110101111
1000000001000000001
1011011101011101101
1C0100000C0000010C1
1101010111110101011
1000010001000100001
1011111101011111101
100000000C000000001
1111111111111111111
